year,team_id,team_name,wins,losses,ties,total_games
2017,26172,A&M-Corpus Chris,17,31,6,54
2017,2,Abilene Christian,12,33,11,56
2017,30123,Academy of Art,20,30,0,50
2017,929,Adams St.,13,33,0,46
2017,3,Adelphi,24,24,0,48
2017,4,Adrian,30,10,1,41
2017,721,Air Force,24,22,7,53
2017,10,Ala.-Huntsville,24,26,0,50
2017,8,Alabama,18,29,8,55
2017,6,Alabama A&M,12,41,2,55
2017,7,Alabama St.,27,23,2,52
2017,14,Albany (NY),19,22,7,48
2017,13,Albany St. (GA),19,30,0,49
2017,2798,Albertus Magnus,10,21,1,32
2017,15,Albion,15,24,0,39
2017,16,Albright,12,25,0,37
2017,17,Alcorn,11,31,1,43
2017,934,Alderson Broaddus,21,20,1,42
2017,30170,Alfred St.,10,30,0,40
2017,19,Allegheny,23,17,0,40
2017,21,Alma,15,25,0,40
2017,938,Alvernia,28,13,2,43
2017,22,American Int'l,16,28,0,44
2017,24,Amherst,19,14,0,33
2017,939,Anderson (IN),14,23,0,37
2017,13028,Anderson (SC),16,32,0,48
2017,25,Angelo St.,39,11,1,51
2017,26,Anna Maria,7,31,0,38
2017,27,Appalachian St.,19,29,7,55
2017,966,Arcadia,32,11,0,43
2017,29,Arizona,31,15,10,56
2017,28,Arizona St.,20,24,11,55
2017,30105,Ark.-Fort Smith,31,18,1,50
2017,8411,Ark.-Monticello,29,19,1,49
2017,2678,Ark.-Pine Bluff,15,30,2,47
2017,31,Arkansas,35,13,6,54
2017,30,Arkansas St.,22,24,7,53
2017,947,Arkansas Tech,34,19,1,54
2017,33,Armstrong St.,23,25,0,48
2017,725,Army West Point,25,29,1,55
2017,35,Ashland,20,29,0,49
2017,36,Assumption,17,25,0,42
2017,37,Auburn,32,17,7,56
2017,38,Augsburg,19,21,0,40
2017,39,Augusta,21,25,0,46
2017,40,Augustana (IL),28,12,0,40
2017,41,Augustana (SD),35,20,1,56
2017,30093,AUM,27,23,0,50
2017,42,Aurora,24,14,0,38
2017,953,Austin,12,25,0,37
2017,43,Austin Peay,20,25,8,53
2017,44,Averett,9,26,0,35
2017,30146,Azusa Pacific,38,9,3,50
2017,45,Babson,25,13,0,38
2017,46,Baldwin Wallace,22,17,0,39
2017,47,Ball St.,25,22,9,56
2017,962,Bard,9,28,0,37
2017,49,Barry,23,27,0,50
2017,15646,Barton,28,23,0,51
2017,58,Baruch,17,19,0,36
2017,50,Bates,15,15,1,31
2017,51,Baylor,27,17,9,53
2017,26107,Becker,19,19,0,38
2017,30197,Belhaven,24,14,0,38
2017,52,Bellarmine,33,17,1,51
2017,14927,Belmont,23,23,9,55
2017,2683,Belmont Abbey,33,17,0,50
2017,53,Beloit,17,17,1,35
2017,54,Bemidji St.,19,31,0,50
2017,55,Benedict,25,16,0,41
2017,296,Benedictine (IL),23,15,1,39
2017,56,Bentley,11,29,1,41
2017,30171,Berea,14,25,0,39
2017,973,Berry,23,21,0,44
2017,59,Bethany (WV),14,22,1,37
2017,30038,Bethany Lutheran,20,17,0,37
2017,60,Bethel (MN),31,8,1,40
2017,61,Bethune-Cookman,27,23,3,53
2017,62,Binghamton,26,9,7,42
2017,28593,Birmingham-So.,36,8,0,44
2017,64,Blackburn,7,31,0,38
2017,984,Bloomfield,18,22,0,40
2017,65,Bloomsburg,22,24,1,47
2017,985,Bluefield St.,12,32,0,44
2017,987,Bluffton,15,20,0,35
2017,67,Boston College,19,26,7,52
2017,69,Bowdoin,15,18,0,33
2017,71,Bowling Green,12,30,8,50
2017,72,Bradley,19,25,6,50
2017,73,Brandeis,6,21,0,27
2017,30094,Brevard,10,37,0,47
2017,74,Bridgeport,19,23,0,42
2017,75,Bridgewater (VA),14,25,0,39
2017,76,Bridgewater St.,10,21,0,31
2017,78,Brockport,23,16,0,39
2017,80,Brown,13,24,0,37
2017,81,Bryant,26,21,5,52
2017,83,Bucknell,19,26,0,45
2017,84,Buena Vista,24,15,1,40
2017,86,Buffalo,16,27,8,51
2017,87,Butler,27,17,7,51
2017,77,BYU,29,14,8,51
2017,88,Cabrini,10,22,0,32
2017,1305,Cairn,17,17,0,34
2017,105,Cal Lutheran,30,10,0,40
2017,90,Cal Poly,21,25,10,56
2017,91,Cal Poly Pomona,31,18,1,50
2017,92,Cal St. Dom. Hills,14,35,0,49
2017,98,Cal St. East Bay,25,24,0,49
2017,97,Cal St. Fullerton,28,16,11,55
2017,100,Cal St. L.A.,26,22,1,49
2017,30055,Cal St. Monterey Bay,28,22,1,51
2017,93,Cal St. San B'dino,15,35,0,50
2017,30198,Cal St. San Marcos,17,33,0,50
2017,995,Caldwell,12,27,0,39
2017,107,California,21,24,9,54
2017,106,California (PA),20,24,0,44
2017,30135,California Baptist,32,15,3,50
2017,89,Caltech,8,30,0,38
2017,114,Calvin,19,21,1,41
2017,996,Cameron,29,18,1,48
2017,115,Campbell,21,25,9,55
2017,116,Canisius,29,18,7,54
2017,117,Capital,17,20,0,37
2017,118,Carleton,9,27,0,36
2017,120,Carroll (WI),13,27,0,40
2017,1000,Carson-Newman,29,24,0,53
2017,121,Carthage,20,18,0,38
2017,123,Castleton,33,8,1,42
2017,1001,Catawba,37,15,0,52
2017,124,Catholic,27,13,0,40
2017,23624,Cazenovia,4,23,1,28
2017,480,CCNY,11,22,0,33
2017,30124,Cedarville,17,28,1,46
2017,125,Centenary (LA),34,8,0,42
2017,12884,Centenary (NJ),5,25,0,30
2017,126,Central (IA),20,20,1,41
2017,1004,Central Ark.,27,20,9,56
2017,127,Central Conn. St.,26,18,9,53
2017,129,Central Mich.,25,21,9,55
2017,130,Central Mo.,32,16,1,49
2017,1009,Central Okla.,30,17,2,49
2017,1010,Central Wash.,28,21,1,50
2017,132,Centre,18,22,0,40
2017,134,Chapman,26,14,0,40
2017,1013,Charleston (WV),29,20,2,51
2017,48,Charleston So.,21,23,7,51
2017,458,Charlotte,27,20,7,54
2017,10972,Chatham,5,9,0,14
2017,21323,Chestnut Hill,21,19,2,42
2017,137,Chicago,21,11,5,37
2017,136,Chicago St.,11,33,8,52
2017,95,Chico St.,41,8,1,50
2017,8875,Chowan,27,25,0,52
2017,139,Chris. Newport,25,15,0,40
2017,1015,Christian Bros.,15,34,0,49
2017,140,Cincinnati,24,23,8,55
2017,30058,Claflin,16,33,0,49
2017,142,Claremont-M-S,16,21,0,37
2017,143,Clarion,13,31,0,44
2017,145,Clark (MA),26,13,0,39
2017,144,Clark Atlanta,13,25,0,38
2017,958,Clarks Summit,8,22,0,30
2017,146,Clarkson,16,16,0,32
2017,147,Clemson,36,12,8,56
2017,722,Coast Guard,12,23,0,35
2017,149,Coastal Caro.,30,16,10,56
2017,150,Coe,21,16,1,38
2017,1023,Coker,22,23,0,45
2017,1014,Col. of Charleston,22,25,8,55
2017,151,Colby,10,25,1,36
2017,152,Colby-Sawyer,19,19,0,38
2017,11403,Colo. Christian,17,32,0,49
2017,155,Colo. Sch. of Mines,29,20,1,50
2017,11416,Colorado Mesa,40,10,1,51
2017,2720,Colorado St.-Pueblo,23,24,1,48
2017,158,Columbia,18,23,0,41
2017,159,Columbus St.,29,19,1,49
2017,1028,Concord,26,23,0,49
2017,30199,Concordia (CA),21,26,3,50
2017,162,Concordia (NY),10,28,0,38
2017,24400,Concordia (TX),28,16,0,44
2017,160,Concordia Chicago,26,11,0,37
2017,30200,Concordia Portland,15,35,0,50
2017,1036,Concordia Wisconsin,26,11,0,37
2017,161,Concordia-M'head,22,17,0,39
2017,9081,Concordia-St. Paul,23,24,1,48
2017,165,Coppin St.,11,30,2,43
2017,167,Cornell,21,17,0,38
2017,166,Cornell College,18,18,0,36
2017,30111,Covenant,14,24,0,38
2017,169,Creighton,21,18,9,48
2017,30035,Crown (MN),14,18,0,32
2017,94,CSU Bakersfield,26,17,8,51
2017,101,CSUN,23,25,7,55
2017,170,Curry,15,20,0,35
2017,122,CWRU,24,16,0,40
2017,1059,D'Youville,4,26,0,30
2017,1044,Dallas,14,26,0,40
2017,2691,Daniel Webster,6,22,0,28
2017,172,Dartmouth,22,17,1,40
2017,173,Davidson,24,21,5,50
2017,174,Davis & Elkins,11,34,0,45
2017,175,Dayton,16,30,9,55
2017,1045,DBU,30,17,8,55
2017,1050,Defiance,14,25,0,39
2017,180,Delaware,25,20,6,51
2017,178,Delaware St.,19,22,2,43
2017,179,Delaware Valley,15,18,0,33
2017,181,Delta St.,40,11,0,51
2017,182,Denison,29,10,0,39
2017,177,DePauw,29,9,0,38
2017,20,DeSales,25,15,1,41
2017,185,Dickinson,20,20,0,40
2017,30095,Dixie St.,36,10,4,50
2017,1332,Dominican (IL),18,21,0,39
2017,8956,Dominican (NY),18,26,1,45
2017,190,Drew,26,14,0,40
2017,1057,Drury,33,17,1,51
2017,192,Dubuque,23,15,1,39
2017,193,Duke,23,23,9,55
2017,195,Earlham,26,12,0,38
2017,196,East Carolina,24,24,8,56
2017,8965,East Central,11,29,0,40
2017,197,East Stroudsburg,25,19,2,46
2017,1062,East Tex. Baptist,30,13,2,45
2017,203,East. Mennonite,19,20,0,39
2017,8968,Eastern,14,21,0,35
2017,200,Eastern Conn. St.,20,14,0,34
2017,201,Eastern Ill.,17,31,7,55
2017,202,Eastern Ky.,23,25,8,56
2017,204,Eastern Mich.,18,30,8,56
2017,206,Eastern N.M.,32,18,0,50
2017,1064,Eastern Nazarene,11,22,2,35
2017,208,Eckerd,19,28,3,50
2017,1066,Edgewood,21,17,0,38
2017,211,Elizabethtown,24,14,0,38
2017,212,Elmhurst,21,18,0,39
2017,213,Elmira,16,15,0,31
2017,532,Elms,18,20,0,38
2017,1068,Elon,21,27,7,55
2017,9680,Embry-Riddle (FL),14,35,0,49
2017,214,Emerson,8,21,0,29
2017,30193,Emmanuel (GA),18,32,0,50
2017,217,Emory,27,12,0,39
2017,216,Emory & Henry,17,23,0,40
2017,1071,Emporia St.,40,9,1,50
2017,8981,Endicott,25,17,0,42
2017,1072,Erskine,25,25,0,50
2017,198,ETSU,21,25,8,54
2017,218,Eureka,5,28,0,33
2017,219,Evansville,15,31,8,54
2017,220,Fairfield,27,18,7,52
2017,222,Fairleigh Dickinson,12,26,8,46
2017,1076,Fairmont St.,28,22,0,50
2017,27892,Farmingdale St.,21,15,0,36
2017,221,FDU-Florham,12,20,0,32
2017,23157,Felician,33,13,0,46
2017,225,Ferrum,22,18,0,40
2017,28755,FGCU,31,16,7,54
2017,1079,Findlay,17,27,0,44
2017,30032,Finlandia,8,24,0,32
2017,227,Fitchburg St.,14,20,1,35
2017,231,FIU,27,23,6,56
2017,229,Fla. Atlantic,29,16,8,53
2017,233,Fla. Southern,33,13,3,49
2017,30092,Flagler,28,22,1,51
2017,235,Florida,35,13,7,55
2017,228,Florida A&M,24,23,3,50
2017,234,Florida St.,31,18,8,57
2017,230,Florida Tech,28,19,3,50
2017,11538,Fontbonne,18,21,0,39
2017,236,Fordham,22,22,6,50
2017,9011,Fort Hays St.,10,39,0,49
2017,308,Fort Wayne,8,36,8,52
2017,238,Framingham St.,20,22,0,42
2017,1085,Francis Marion,29,19,0,48
2017,239,Frank. & Marsh.,21,18,1,40
2017,2694,Franklin,21,17,0,38
2017,241,Franklin Pierce,30,13,1,44
2017,242,Fredonia,16,20,0,36
2017,30147,Fresno Pacific,19,24,2,45
2017,96,Fresno St.,25,22,8,55
2017,243,Frostburg St.,17,19,0,36
2017,244,Furman,25,22,8,55
2017,253,Ga. Southern,32,16,8,56
2017,1097,Ga. Southwestern,19,27,1,47
2017,245,Gallaudet,9,31,0,40
2017,246,Gannon,19,24,0,43
2017,1092,Gardner-Webb,22,25,6,53
2017,30084,Geneva,8,27,0,35
2017,1094,George Fox,18,20,0,38
2017,248,George Mason,22,27,7,56
2017,249,George Washington,26,23,6,55
2017,251,Georgetown,25,22,9,56
2017,257,Georgia,19,29,8,56
2017,1096,Georgia College,31,13,1,45
2017,254,Georgia St.,19,28,7,54
2017,255,Georgia Tech,24,21,8,53
2017,258,Gettysburg,22,17,2,41
2017,1098,Glenville St.,19,30,0,49
2017,8366,Goldey-Beacom,10,35,0,45
2017,260,Gonzaga,26,16,8,50
2017,1099,Gordon,13,22,0,35
2017,261,Grambling,22,27,1,50
2017,1104,Grand Canyon,24,22,8,54
2017,262,Grand Valley St.,29,21,1,51
2017,263,Greensboro,23,20,0,43
2017,1111,Greenville,26,14,1,41
2017,264,Grinnell,20,14,0,34
2017,265,Grove City,17,17,2,36
2017,1112,Guilford,22,17,0,39
2017,266,Gust. Adolphus,21,17,0,38
2017,12399,Gwynedd Mercy,23,14,2,39
2017,267,Hamilton,15,17,0,32
2017,268,Hamline,16,24,0,40
2017,269,Hampden-Sydney,21,19,0,40
2017,1115,Hanover,18,20,0,38
2017,271,Hardin-Simmons,20,23,0,43
2017,1116,Harding,23,29,0,52
2017,272,Hartford,19,22,7,48
2017,275,Harvard,19,23,0,42
2017,276,Haverford,20,16,1,37
2017,277,Hawaii,25,17,9,51
2017,2697,Hawaii Hilo,8,31,1,40
2017,2696,Hawaii Pacific,20,28,2,50
2017,278,Heidelberg,22,17,0,39
2017,1123,Henderson St.,30,19,1,50
2017,1124,Hendrix,20,22,0,42
2017,19651,High Point,25,18,7,50
2017,8398,Hilbert,8,24,0,32
2017,280,Hillsdale,24,24,1,49
2017,281,Hiram,16,19,0,35
2017,283,Hofstra,13,32,6,51
2017,285,Holy Cross,19,25,0,44
2017,30175,Holy Names,14,36,0,50
2017,8404,Hood,20,20,0,40
2017,286,Hope,24,17,1,42
2017,30160,Houghton,14,21,0,35
2017,288,Houston,30,17,8,55
2017,287,Houston Baptist,23,20,6,49
2017,2741,Howard Payne,18,22,0,40
2017,1130,Huntingdon,13,24,0,37
2017,1133,Husson,22,20,0,42
2017,30172,IIT,11,28,0,39
2017,300,Ill. Wesleyan,20,18,0,38
2017,302,Ill.-Chicago,32,12,7,51
2017,30050,Ill.-Springfield,31,19,1,51
2017,301,Illinois,21,24,6,51
2017,297,Illinois Col.,11,23,0,34
2017,299,Illinois St.,12,34,6,52
2017,303,Immaculata,23,10,1,34
2017,2743,Incarnate Word,19,29,7,55
2017,306,Indiana,27,17,10,54
2017,307,Indiana (PA),22,23,0,45
2017,305,Indiana St.,24,20,7,51
2017,310,Iona,17,21,7,45
2017,312,Iowa,29,17,7,53
2017,30173,Iowa Wesleyan,15,22,0,37
2017,313,Ithaca,25,11,0,36
2017,314,Jackson St.,36,14,2,52
2017,316,Jacksonville,27,20,8,55
2017,315,Jacksonville St.,25,21,8,54
2017,317,James Madison,21,22,9,52
2017,320,John Carroll,18,20,0,38
2017,321,John Jay,13,25,0,38
2017,322,Johns Hopkins,36,6,0,42
2017,22626,Johnson & Wales (RI),23,19,0,42
2017,325,Juniata,6,33,0,39
2017,326,Kalamazoo,28,12,1,41
2017,328,Kansas,27,22,7,56
2017,327,Kansas St.,26,22,7,55
2017,329,Kean,23,19,0,42
2017,330,Keene St.,14,21,0,35
2017,1157,Kennesaw St.,20,25,8,53
2017,331,Kent St.,31,13,7,51
2017,334,Kentucky,32,16,8,56
2017,332,Kentucky St.,20,34,0,54
2017,335,Kenyon,17,23,0,40
2017,1159,Keuka,16,15,2,33
2017,30047,Keystone,28,12,1,41
2017,30051,King (TN),19,27,0,46
2017,336,King's (PA),20,16,1,37
2017,337,Knox,16,17,0,33
2017,339,Kutztown,16,31,0,47
2017,333,Ky. Wesleyan,23,22,1,46
2017,1163,La Roche,31,8,1,40
2017,340,La Salle,10,35,7,52
2017,341,La Verne,21,20,0,41
2017,498,La.-Monroe,12,37,6,55
2017,342,Lafayette,8,44,0,52
2017,1162,LaGrange,38,4,0,42
2017,2746,Lake Erie,11,38,0,49
2017,1164,Lakeland,11,26,0,37
2017,346,Lamar University,28,21,6,55
2017,30085,Lancaster Bible,19,12,1,32
2017,1167,Lander,21,27,1,49
2017,347,Lane,9,29,0,38
2017,8486,Lasell,16,16,0,32
2017,348,Lawrence,5,29,1,35
2017,349,Le Moyne,28,15,1,44
2017,351,Lebanon Valley,20,18,0,38
2017,30013,Lee,27,23,0,50
2017,352,Lehigh,21,29,0,50
2017,279,Lehman,11,25,0,36
2017,350,LeMoyne-Owen,10,31,0,41
2017,1170,Lenoir-Rhyne,22,26,0,48
2017,24317,Lesley,20,17,2,39
2017,8490,LeTourneau,9,28,0,37
2017,354,Lewis,16,34,0,50
2017,22235,Lewis & Clark,7,31,0,38
2017,355,Liberty,28,17,8,53
2017,1174,Limestone,22,25,0,47
2017,357,Lincoln (PA),6,33,0,39
2017,1176,Lincoln Memorial,33,17,0,50
2017,30136,Lindenwood (MO),31,17,1,49
2017,1179,Linfield,30,13,0,43
2017,28600,Lipscomb,25,19,8,52
2017,32,Little Rock,17,30,8,55
2017,361,LIU Brooklyn,17,24,9,50
2017,362,LIU Post,27,18,0,45
2017,360,Lock Haven,31,16,0,47
2017,99,Long Beach St.,30,15,10,55
2017,363,Longwood,16,30,7,53
2017,364,Loras,15,25,0,40
2017,671,Louisiana,28,19,9,56
2017,1182,Louisiana Col.,20,22,0,42
2017,366,Louisiana Tech,32,15,7,54
2017,367,Louisville,42,6,8,56
2017,370,Loyola Marymount,31,14,8,53
2017,365,LSU,32,16,8,56
2017,30177,Lubbock Christian,36,12,1,49
2017,372,Luther,25,15,1,41
2017,374,Lynchburg,17,21,0,38
2017,30065,Lyndon St.,22,20,0,42
2017,20794,Lynn,30,20,0,50
2017,376,Macalester,23,15,1,39
2017,377,MacMurray,20,19,0,39
2017,380,Maine,17,24,7,48
2017,30137,Malone,32,16,1,49
2017,1192,Manchester,21,19,0,40
2017,381,Manhattan,14,31,6,51
2017,382,Manhattanville,18,23,1,42
2017,384,Mansfield,20,29,1,50
2017,1194,Maranatha Baptist,7,27,0,34
2017,1196,Marian (WI),11,27,2,40
2017,385,Marietta,21,16,0,37
2017,386,Marist,25,19,6,50
2017,1199,Mars Hill,29,21,0,50
2017,388,Marshall,24,23,7,54
2017,8597,Martin Luther,7,25,0,32
2017,30075,Mary,12,35,0,47
2017,1203,Mary Hardin-Baylor,22,18,0,40
2017,390,Mary Washington,20,19,0,39
2017,392,Maryland,31,15,8,54
2017,394,Marymount (VA),20,21,0,41
2017,395,Maryville (MO),25,25,0,50
2017,396,Maryville (TN),19,20,0,39
2017,397,Marywood,14,22,0,36
2017,399,Mass. Maritime,12,16,0,28
2017,400,Massachusetts,12,28,7,47
2017,773,McDaniel,13,22,0,35
2017,30138,McKendree,13,34,0,47
2017,486,MCLA,12,18,0,30
2017,8530,McMurry,13,27,0,40
2017,402,McNeese,31,15,8,54
2017,379,Me.-Farmington,5,29,0,34
2017,30040,Me.-Presque Isle,4,28,0,32
2017,23725,Medaille,12,27,0,39
2017,404,Memphis,25,23,8,56
2017,406,Mercer,36,11,8,55
2017,724,Merchant Marine,15,18,0,33
2017,407,Mercy,10,32,0,42
2017,408,Mercyhurst,34,4,0,38
2017,410,Merrimack,23,20,1,44
2017,411,Messiah,16,21,0,37
2017,412,Methodist,17,21,0,38
2017,415,Miami (FL),24,23,8,55
2017,414,Miami (OH),20,30,6,56
2017,418,Michigan,35,11,9,55
2017,416,Michigan St.,24,19,9,52
2017,419,Middle Tenn.,20,27,8,55
2017,420,Middlebury,20,14,2,36
2017,422,Miles,31,19,0,50
2017,423,Millersville,34,17,0,51
2017,424,Millikin,22,18,0,40
2017,426,Millsaps,19,23,0,42
2017,797,Milwaukee,19,27,9,55
2017,427,Minn. Duluth,23,26,1,50
2017,27854,Minn.-Crookston,24,27,1,52
2017,1226,Minn.-Morris,17,18,0,35
2017,428,Minnesota,29,15,6,50
2017,383,Minnesota St.,40,9,1,50
2017,30125,Minot St.,28,20,1,49
2017,16142,Misericordia,28,12,1,41
2017,429,Mississippi Col.,20,28,1,49
2017,430,Mississippi St.,32,17,7,56
2017,432,Mississippi Val.,7,34,0,41
2017,434,Missouri,29,20,7,56
2017,435,Missouri S&T,26,21,1,48
2017,669,Missouri St.,33,14,6,53
2017,398,MIT,21,14,1,36
2017,30042,Mitchell,29,12,1,42
2017,9012,Mo. Southern St.,26,24,1,51
2017,9013,Mo. Western St.,29,18,1,48
2017,436,Mo.-St. Louis,17,30,0,47
2017,437,Molloy,19,27,0,46
2017,439,Monmouth,16,25,7,48
2017,438,Monmouth (IL),16,19,0,35
2017,205,Mont. St. Billings,23,27,1,51
2017,442,Montclair St.,15,22,0,37
2017,1238,Montevallo,25,23,0,48
2017,443,Moravian,16,21,0,37
2017,444,Morehead St.,30,18,7,55
2017,445,Morehouse,8,29,0,37
2017,30036,Mount Aloysius,17,24,1,42
2017,1245,Mount Olive,47,8,0,55
2017,452,Mount Union,29,9,0,38
2017,20220,MSOE,19,19,0,38
2017,413,MSU Denver,25,23,1,49
2017,8567,Mt. St. Joseph,22,18,0,40
2017,1468,Mt. St. Mary (NY),14,28,0,42
2017,450,Mt. St. Mary's,7,36,4,47
2017,451,Mt. St. Vincent,8,31,0,39
2017,453,Muhlenberg,16,21,0,37
2017,454,Murray St.,24,24,7,55
2017,455,Muskingum,15,23,0,38
2017,488,N.C. A&T,25,21,3,49
2017,489,N.C. Central,22,27,2,51
2017,491,N.C. Wesleyan,24,16,0,40
2017,8577,N.M. Highlands,19,27,0,46
2017,726,Navy,37,15,0,52
2017,462,Neb. Wesleyan,13,27,0,40
2017,1156,Neb.-Kearney,14,35,0,49
2017,463,Nebraska,29,16,8,53
2017,1254,Neumann,20,16,1,37
2017,466,Nevada,15,31,7,53
2017,467,New England Col.,24,19,0,43
2017,470,New Haven,25,10,1,36
2017,319,New Jersey City,18,18,0,36
2017,473,New Mexico,28,20,7,55
2017,472,New Mexico St.,30,19,6,55
2017,474,New Orleans,24,23,8,55
2017,1257,Newberry,32,21,0,53
2017,21772,Newbury,18,18,1,37
2017,30054,Newman,21,28,0,49
2017,482,Niagara,21,19,8,48
2017,483,Nicholls St.,25,24,7,56
2017,484,Nichols,22,18,1,41
2017,471,NJIT,7,36,7,50
2017,485,Norfolk St.,24,19,2,45
2017,487,North Ala.,34,18,1,53
2017,457,North Carolina,37,9,9,55
2017,490,North Carolina St.,27,21,7,55
2017,492,North Central (IL),21,15,0,36
2017,30039,North Central (MN),6,26,0,32
2017,493,North Dakota St.,24,22,6,52
2017,2711,North Florida,32,17,6,55
2017,30052,North Georgia,40,8,1,49
2017,9223,North Greenville,38,15,0,53
2017,496,North Park,14,25,0,39
2017,500,Northeastern,22,22,8,52
2017,12810,Northeastern St.,22,25,0,47
2017,502,Northern Colo.,16,27,7,50
2017,503,Northern Ill.,15,31,7,53
2017,505,Northern Ky.,17,30,8,55
2017,1266,Northern St.,24,26,0,50
2017,1267,Northland,13,20,0,33
2017,507,Northwest Mo. St.,31,18,1,50
2017,1274,Northwest Nazarene,23,27,1,51
2017,509,Northwestern,19,27,6,52
2017,30178,Northwestern Okla.,14,34,0,48
2017,508,Northwestern St.,18,28,8,54
2017,30031,Northwestern-St. Paul,15,25,0,40
2017,510,Northwood,39,11,1,51
2017,511,Norwich,12,24,0,36
2017,513,Notre Dame,23,26,7,56
2017,30126,Notre Dame (OH),18,32,0,50
2017,24639,Nova Southeastern,33,16,0,49
2017,1277,Nyack,23,19,0,42
2017,477,NYIT,5,36,1,42
2017,479,NYU,23,13,0,36
2017,514,Oakland,12,33,8,53
2017,1278,Oakland City,18,25,0,43
2017,515,Oberlin,22,18,2,42
2017,516,Occidental,22,17,0,39
2017,2713,Oglethorpe,18,22,0,40
2017,519,Ohio,22,24,7,53
2017,30119,Ohio Dominican,25,24,0,49
2017,517,Ohio Northern,21,19,0,40
2017,518,Ohio St.,18,29,9,56
2017,15207,Ohio Valley,27,21,1,49
2017,520,Ohio Wesleyan,14,26,0,40
2017,30202,Okla. Baptist,32,15,0,47
2017,30179,Okla. Christian,28,21,0,49
2017,24342,Okla. Panhandle,10,40,0,50
2017,522,Oklahoma,32,17,6,55
2017,521,Oklahoma St.,24,21,8,53
2017,523,Old Dominion,32,14,9,55
2017,524,Old Westbury,20,16,0,36
2017,433,Ole Miss,29,20,7,56
2017,525,Olivet,8,32,0,40
2017,464,Omaha,12,32,8,52
2017,527,Oral Roberts,33,13,8,54
2017,529,Oregon,26,17,11,54
2017,528,Oregon St.,38,4,11,53
2017,530,Oswego St.,28,8,0,36
2017,531,Otterbein,28,12,0,40
2017,1289,Ouachita Baptist,16,35,0,51
2017,23008,Ozarks (AR),11,26,0,37
2017,533,Pace,28,17,1,46
2017,534,Pacific,15,30,7,52
2017,2751,Pacific (OR),15,23,0,38
2017,1297,Pacific Lutheran,25,14,0,39
2017,535,Paine,21,21,0,42
2017,30045,Palm Beach Atl.,27,23,0,50
2017,540,Penn,23,20,0,43
2017,30190,Penn College,23,10,2,35
2017,539,Penn St.,14,32,8,54
2017,30081,Penn St. Harrisburg,16,23,0,39
2017,30114,Penn St.-Abington,15,21,0,36
2017,25719,Penn St.-Altoona,19,21,0,40
2017,538,Penn St.-Behrend,21,17,1,39
2017,30044,Penn St.-Berks,17,19,0,36
2017,541,Pepperdine,18,27,7,52
2017,542,Pfeiffer,24,25,0,49
2017,543,Philadelphia U.,19,27,1,47
2017,21830,Piedmont,24,20,0,44
2017,1315,Pitt.-Bradford,15,23,0,38
2017,11839,Pitt.-Greensburg,18,15,1,34
2017,546,Pitt.-Johnstown,18,31,0,49
2017,1314,Pittsburg St.,23,27,0,50
2017,545,Pittsburgh,21,24,8,53
2017,547,Plattsburgh St.,13,23,0,36
2017,548,Plymouth St.,19,19,0,38
2017,30149,Point Loma,30,17,2,49
2017,549,Pomona-Pitzer,18,21,0,39
2017,551,Portland,9,34,9,52
2017,1318,Post,20,23,1,44
2017,553,Prairie View,18,33,2,53
2017,1320,Presbyterian,24,24,8,56
2017,554,Princeton,12,28,1,41
2017,555,Principia,17,19,0,36
2017,557,Puget Sound,14,24,0,38
2017,30029,Purchase,9,18,0,27
2017,559,Purdue,26,20,9,55
2017,560,Queens (NY),18,23,0,41
2017,561,Quincy,28,20,1,49
2017,562,Quinnipiac,17,28,6,51
2017,563,Radford,20,25,8,53
2017,564,Ramapo,24,16,1,41
2017,565,Randolph-Macon,26,15,0,41
2017,567,Redlands,27,16,0,43
2017,568,Regis (CO),25,24,1,50
2017,570,Rensselaer,18,21,0,39
2017,572,Rhode Island,28,16,6,50
2017,571,Rhode Island Col.,17,17,0,34
2017,573,Rhodes,25,19,0,44
2017,574,Rice,22,26,8,56
2017,575,Richmond,14,30,9,53
2017,576,Rider,18,24,9,51
2017,577,Ripon,9,26,0,35
2017,580,RIT,30,7,0,37
2017,18422,Rivier,3,29,0,32
2017,578,Roanoke,28,16,0,44
2017,581,Rochester (NY),12,18,0,30
2017,582,Rockford,17,22,0,39
2017,1328,Rockhurst,23,25,0,48
2017,583,Roger Williams,12,27,0,39
2017,30180,Rogers St.,31,19,0,50
2017,584,Rollins,27,20,3,50
2017,585,Rose-Hulman,18,22,0,40
2017,259,Rowan,28,15,1,44
2017,587,Rutgers,17,28,6,51
2017,588,Rutgers-Camden,15,23,0,38
2017,589,Rutgers-Newark,24,15,1,40
2017,11276,S.C. Aiken,38,11,1,50
2017,102,Sacramento St.,24,24,7,55
2017,590,Sacred Heart,16,29,9,54
2017,591,Saginaw Valley,20,28,0,48
2017,594,Saint Augustine's,18,34,0,52
2017,602,Saint John's (MN),25,11,1,37
2017,606,Saint Joseph's,16,24,6,46
2017,608,Saint Leo,21,25,3,49
2017,609,Saint Louis,26,18,8,52
2017,1343,Saint Martin's,17,30,0,47
2017,610,Saint Mary's (CA),30,17,8,55
2017,612,Saint Mary's (MN),19,20,0,39
2017,613,Saint Michael's,4,25,0,29
2017,617,Saint Peter's,0,32,6,38
2017,1347,Saint Rose,7,28,0,35
2017,30064,Saint Vincent,14,21,0,35
2017,19117,Salem Int'l,7,39,0,46
2017,621,Salem St.,22,20,0,42
2017,622,Salisbury,31,9,0,40
2017,623,Salve Regina,31,9,1,41
2017,624,Sam Houston St.,31,17,8,56
2017,625,Samford,27,21,8,56
2017,627,San Diego,29,16,9,54
2017,626,San Diego St.,34,15,7,56
2017,628,San Fran. St.,18,32,0,50
2017,629,San Francisco,24,25,8,57
2017,630,San Jose St.,15,30,10,55
2017,631,Santa Clara,11,35,7,53
2017,632,Savannah St.,12,35,4,51
2017,1355,Schreiner,13,27,0,40
2017,633,Scranton,19,19,0,38
2017,1356,Seattle U,16,28,9,53
2017,635,Seton Hall,24,20,8,52
2017,30063,Seton Hill,32,18,0,50
2017,652,Sewanee,19,23,0,42
2017,676,SFA,26,23,6,55
2017,637,Shenandoah,36,8,0,44
2017,10870,Shepherd,28,21,0,49
2017,638,Shippensburg,28,20,1,49
2017,30151,Shorter,23,23,0,46
2017,639,Siena,17,24,9,50
2017,641,Simpson,7,29,0,36
2017,30128,Sioux Falls,19,31,0,50
2017,660,SIUE,21,24,7,52
2017,642,Skidmore,10,24,0,34
2017,643,Slippery Rock,26,18,0,44
2017,645,Sonoma St.,24,21,0,45
2017,646,South Ala.,30,18,7,55
2017,648,South Carolina,27,19,8,54
2017,649,South Dakota St.,19,22,6,47
2017,651,South Fla.,37,10,8,55
2017,654,Southeast Mo. St.,24,22,6,52
2017,655,Southeastern La.,31,16,7,54
2017,1371,Southeastern Okla.,16,29,1,46
2017,1376,Southern Ark.,38,12,1,51
2017,657,Southern California,19,25,11,55
2017,658,Southern Conn. St.,27,13,2,42
2017,659,Southern Ill.,23,26,7,56
2017,661,Southern Ind.,32,17,1,50
2017,662,Southern Me.,28,9,0,37
2017,664,Southern Miss.,37,12,7,56
2017,468,Southern N.H.,39,7,1,47
2017,30152,Southern Nazarene,7,40,0,47
2017,665,Southern U.,15,24,0,39
2017,30164,Southern Va.,12,28,0,40
2017,1379,Southern Vt.,8,26,0,34
2017,30192,Southern Wesleyan,15,34,0,49
2017,2755,Southwest Baptist,30,19,1,50
2017,8736,Southwest Minn. St.,15,33,0,48
2017,8746,Southwestern (TX),21,20,0,41
2017,8744,Southwestern Okla.,18,27,0,45
2017,23260,Spalding,26,14,1,41
2017,30191,Spring Hill,29,20,0,49
2017,673,Springfield,15,14,0,29
2017,593,St. Anselm,11,32,0,43
2017,596,St. Bonaventure,24,16,6,46
2017,598,St. Cloud St.,36,14,1,51
2017,1334,St. Edward's,30,18,1,49
2017,601,St. John Fisher,28,8,0,36
2017,603,St. John's (NY),34,8,7,49
2017,30072,St. Joseph's (Brkln),14,19,0,33
2017,604,St. Joseph's (IN),32,18,1,51
2017,1340,St. Joseph's (L.I.),25,14,0,39
2017,605,St. Joseph's (ME),31,8,0,39
2017,607,St. Lawrence,11,21,0,32
2017,611,St. Mary's (MD),9,22,0,31
2017,1346,St. Mary's (TX),23,24,1,48
2017,614,St. Norbert,26,10,0,36
2017,615,St. Olaf,16,23,0,39
2017,618,St. Scholastica,29,8,0,37
2017,620,St. Thomas (MN),25,14,1,40
2017,1348,St. Thomas Aquinas,37,13,0,50
2017,674,Stanford,30,13,11,54
2017,103,Stanislaus St.,34,16,1,51
2017,675,Staten Island,27,11,1,39
2017,678,Stetson,22,26,6,54
2017,679,Stevens,18,21,1,40
2017,21852,Stevenson,18,22,0,40
2017,681,Stockton,15,19,0,34
2017,682,Stonehill,15,27,0,42
2017,683,Stony Brook,21,23,6,50
2017,684,Suffolk,25,13,0,38
2017,1390,Sul Ross St.,14,26,0,40
2017,30165,SUNY Canton,10,27,0,37
2017,168,SUNY Cortland,33,7,0,40
2017,478,SUNY Maritime,26,11,0,37
2017,475,SUNY New Paltz,17,17,0,34
2017,526,SUNY Oneonta,14,20,0,34
2017,9500,SUNY Poly,8,26,0,34
2017,685,Susquehanna,22,17,0,39
2017,686,Swarthmore,16,22,0,38
2017,689,Tampa,34,12,3,49
2017,1395,Tarleton St.,28,20,0,48
2017,712,TCNJ,31,11,1,43
2017,698,TCU,35,11,7,53
2017,694,Tennessee,24,19,9,52
2017,692,Tennessee Tech,34,15,7,56
2017,30090,Tex. A&M Int'l,12,32,0,44
2017,696,Tex. A&M-Kingsville,31,16,1,48
2017,30088,Tex. Permian Basin,9,40,0,49
2017,703,Texas,31,19,4,54
2017,697,Texas A&M,34,15,7,56
2017,1400,Texas Lutheran,21,19,0,40
2017,699,Texas Southern,16,31,0,47
2017,670,Texas St.,24,25,7,56
2017,700,Texas Tech,39,13,3,55
2017,23121,Texas-Dallas,33,11,0,44
2017,30028,Texas-Tyler,37,7,2,46
2017,141,The Citadel,14,30,6,50
2017,707,Thiel,21,17,0,38
2017,2758,Thomas (ME),7,31,1,39
2017,1402,Thomas More,26,10,1,37
2017,1403,Tiffin,29,20,1,50
2017,709,Toledo,14,33,9,56
2017,711,Towson,17,29,8,54
2017,28749,Transylvania,13,24,0,37
2017,30002,Trevecca Nazarene,20,21,1,42
2017,30037,Trine,19,18,0,37
2017,713,Trinity (CT),22,14,0,36
2017,715,Trinity (TX),27,15,0,42
2017,716,Troy,26,21,8,55
2017,499,Truman,18,30,0,48
2017,717,Tufts,26,7,1,34
2017,718,Tulane,23,26,7,56
2017,12830,Tusculum,30,20,0,50
2017,720,Tuskegee,23,28,0,51
2017,9,UAB,22,26,7,55
2017,108,UC Davis,15,24,11,50
2017,109,UC Irvine,17,28,11,56
2017,111,UC Riverside,18,26,9,53
2017,112,UC San Diego,32,15,1,48
2017,104,UC Santa Barbara,20,24,12,56
2017,9754,UC-Colo. Springs,22,25,1,48
2017,128,UCF,33,15,8,56
2017,110,UCLA,24,20,11,55
2017,164,UConn,25,20,9,54
2017,309,UIndy,27,23,0,50
2017,401,UMass Boston,29,9,0,38
2017,656,UMass Dartmouth,22,18,0,40
2017,368,UMass Lowell,22,22,3,47
2017,391,UMBC,18,19,7,44
2017,393,UMES,12,36,3,51
2017,456,UNC Asheville,19,26,8,53
2017,537,UNC Pembroke,37,13,1,51
2017,459,UNCG,28,18,6,52
2017,460,UNCW,24,22,9,55
2017,727,Union (NY),20,13,0,33
2017,30153,Union (TN),33,20,0,53
2017,465,UNLV,18,32,6,56
2017,728,Upper Iowa,19,29,0,48
2017,30104,Urbana,17,29,0,46
2017,730,Ursinus,25,16,0,41
2017,10411,USC Upstate,21,26,8,55
2017,28594,USciences,13,27,0,40
2017,702,UT Arlington,29,18,7,54
2017,695,UT Martin,23,24,7,54
2017,732,Utah,20,21,10,51
2017,30024,Utah Valley,15,30,7,52
2017,733,Utica,18,18,0,36
2017,536,UTRGV,25,23,6,54
2017,706,UTSA,25,21,7,53
2017,30181,UVa-Wise,19,31,0,50
2017,745,Va. Wesleyan,21,20,0,41
2017,734,Valdosta St.,33,20,0,53
2017,30166,Valley Forge,8,23,0,31
2017,735,Valparaiso,20,27,8,55
2017,736,Vanderbilt,29,18,8,55
2017,737,Vassar,19,17,0,36
2017,740,VCU,29,18,7,54
2017,739,Villanova,13,27,8,48
2017,746,Virginia,36,11,7,54
2017,743,Virginia St.,20,26,0,46
2017,742,Virginia Tech,20,27,8,55
2017,741,VMI,20,27,7,54
2017,747,Wabash,22,16,2,40
2017,748,Wagner,16,23,8,47
2017,749,Wake Forest,32,14,9,55
2017,30141,Walsh,32,16,1,49
2017,750,Wartburg,28,12,1,41
2017,751,Wash. & Jeff.,30,9,0,39
2017,752,Wash. & Lee,28,13,0,41
2017,2814,Washburn,21,28,0,49
2017,756,Washington,24,20,10,54
2017,753,Washington Col.,15,23,0,38
2017,754,Washington St.,22,22,10,54
2017,755,Washington-St. Louis,22,8,4,34
2017,757,Wayne St. (MI),31,17,1,49
2017,1433,Wayne St. (NE),28,22,1,51
2017,1434,Waynesburg,18,21,2,41
2017,759,Webster,28,11,1,40
2017,761,Wells,13,21,0,34
2017,762,Wentworth,15,16,0,31
2017,763,Wesley,19,15,0,34
2017,764,Wesleyan (CT),19,16,0,35
2017,358,West Ala.,33,18,1,52
2017,765,West Chester,33,9,0,42
2017,11740,West Florida,28,23,1,52
2017,766,West Ga.,17,30,0,47
2017,1438,West Liberty,28,19,0,47
2017,767,West Tex. A&M,32,16,1,49
2017,9630,West Va. Wesleyan,21,28,0,49
2017,768,West Virginia,27,19,8,54
2017,1439,West Virginia St.,21,25,2,48
2017,769,Western Caro.,24,23,7,54
2017,770,Western Conn. St.,15,20,0,35
2017,771,Western Ill.,18,25,6,49
2017,772,Western Ky.,14,35,6,55
2017,774,Western Mich.,19,22,9,50
2017,775,Western New Eng.,22,18,0,40
2017,1446,Western Ore.,28,15,1,44
2017,777,Westfield St.,28,9,0,37
2017,1450,Westminster (MO),19,11,1,31
2017,1451,Westminster (PA),11,22,1,34
2017,778,Wheaton (IL),24,16,0,40
2017,779,Wheaton (MA),23,14,0,37
2017,12799,Wheeling Jesuit,7,35,0,42
2017,780,Whitman,17,20,0,37
2017,781,Whittier,12,27,0,39
2017,1454,Whitworth,24,17,0,41
2017,782,Wichita St.,22,25,8,55
2017,783,Widener,26,14,0,40
2017,784,Wilkes,10,24,0,34
2017,785,Willamette,28,14,0,42
2017,786,William & Mary,28,21,6,55
2017,30120,William Jewell,21,25,1,47
2017,17094,William Peace,17,21,0,38
2017,789,Williams,19,11,0,30
2017,1460,Wilmington (DE),29,19,1,49
2017,1461,Wilmington (OH),6,32,0,38
2017,1462,Wingate,19,31,0,50
2017,790,Winona St.,17,33,0,50
2017,791,Winston-Salem,35,17,0,52
2017,792,Winthrop,26,18,9,53
2017,8911,Wis. Lutheran,16,21,0,37
2017,795,Wis.-La Crosse,25,15,0,40
2017,798,Wis.-Oshkosh,22,18,0,40
2017,799,Wis.-Parkside,18,22,0,40
2017,800,Wis.-Platteville,19,21,0,40
2017,802,Wis.-Stevens Point,19,17,2,38
2017,803,Wis.-Stout,10,27,0,37
2017,804,Wis.-Superior,15,25,0,40
2017,805,Wis.-Whitewater,32,6,0,38
2017,806,Wittenberg,13,23,0,36
2017,787,Wm. Paterson,15,21,2,38
2017,2915,Wofford,25,23,8,56
2017,807,Wooster,32,8,0,40
2017,809,Worcester St.,17,20,0,37
2017,808,WPI,25,12,0,37
2017,810,Wright St.,32,15,8,55
2017,812,Xavier,25,21,8,54
2017,813,Yale,27,16,0,43
2017,814,Yeshiva,2,23,0,25
2017,815,York (PA),18,23,0,41
2017,30154,Young Harris,15,30,0,45
2017,817,Youngstown St.,15,31,10,56
